1 1 1 1 1
2 2 2 2 2
1 3 4 3 1
1 4 2 3 1
1 3 4 4 1
1 1 1 1 1
6 6 6 6 6